........
.#.#....
.#.#...#
.###....
.......#
........
........
........